NO ./texture/flower.png
SO ./texture/fish.png
WE ./texture/sake.png
EA ./texture/chick.png

F 255,244,220
C 25,178,255

1111111111111111111111111111111111111111111111111111111111111111111111111111111111111111111111111111
1N00000000000000000000100000100000000000000010100010100000000000000000101000000000000000000000001001
1010101100101110111010010010101011100111111100100010111010101011101010101011101111000011111010101011
1010000010001010000000000010000000101000001010001000100000100000000000100000000010100000100010100011
1011001010111000111000101010101110110010101011100010101000101001111110001100101110111010101100011011
1000001000000000100010000000000000001010000000000000000010101000000010000000101000000010000010001011
1010110100101011101111101010111010111000100011111110111011101000101011101010011010101010101110100011
1000001000100000100000001000000000100000100000000000000000001000100000101000100000000000001000100011
1010100110001010101110001011111010000000111010001010101010001011101010100111101011011110111010101111
1000000000000000001000001000000000001000001000000010000010100000000000100010100000100000101000000001
1110101000101110111111011110101010100011101110011110111010111010101010001010100010001010101010010011
1010100010100010101010001000000000001010000000000000100000000000000000000010100000001000000000000001
1011101100001111101010111011111010101110111010101000000100001110101110101010001011111111101000111111
1010000000000000100000101010100010001000001000000010001000000000000010000000000000001000000000000011
1010001110101010101010101010100110111010011010111010101010101000001010001011111010001011101011010001
1010100000000000100010100000100000001000000000000000000000001000001000000000000000000000000000001001
1011101110101010100010101011101010101110101111011010101011101010101010100000101010101110101011101101
1010000000100000100000000010001000100010001010001000000000101000001000100010100010101000001000000001
1010110010110011101000101110110001111010101010001000101000101011011010101011101010101000101011100011
1010001000100010000000001010100000100010001000000000000000101000000000100000001000000010100000000001
1000101010001011101010111011110011101110111010011110100110101000111011101110101110101011110000111011
1010000000100010000000000000000000001000000000000000000000000000000010000010100000000000000000001011
1001011110111010101111111000001010100111101010101000111100101110111011001111101010110011100010101111
1000000010101000000000100000100000000000000010001000001000000000101000000000100000000000001010000001
1011101010101110101010101110111010100011101010010100101011110010100010101001001010101010101010101011
1010000010000010001000100000001010000010100000000010001010000000000010000000000000100010101000001011
1011110010100010011010011110001010110010100010011110111110101010101010101010011010001010101010101011
1010001010101010000000101010100000100000001000000000000000100010001000000000101010100000000000001001
1110111110101010101011000011111101001011101111101000010110111101101010111110101011101010111111101011
1000100000100000100010000000000000000000101000001010101010001010000000100000101000000000100000100011
1100000010001001100110111110110011101011001010100011101000011010101010100011101010001111101111101111
1010000010000000000000001000100000000010001010100010100000000010000000001000000000000000101000000001
1010111001001101100011101000101110110110111010111010101010101001001011101011111010101110001011100011
1000001000100000100010001010101010001000100010100000000000000000001000100010000000101000100000001011
1011101010001111101010101011001010001110111011111000101101100110111011110010101011101011101001101001
1000101010000000000000001010100010101010000000000000101000101000001000100000100010001000100000101011
1110110010101010111011101010101000101010111110100100101110101110101011100010000010111001001010100011
1000101010101010000000100010101000000010100000000000000000000000101010101000001010000000100010000001
1111101010111100101011011110011010011110111010101011111010011011111110111110001010001011101110101101
1010001010000000000000001000001000100010000000001000000010001000000010000010000010100000100000001001
1001100010111010001010001110101011111111101111011011111011101110101011011110101100101111101010101011
1010000000001000101000000000100000000000000010000010001010100010001000001000000010001000001000100001
1010111010101100110110101010101010000111001010111110110110101100101011111111010011101011101010111111
1010101010001010000000100000001000000000100000100010000000000010101010001010000000000000100000100011
1010101010001000111100101011101000101001001010101000110111101011011100101011001001111010111011100011
1000000000000010000010100010100000000000000000000010001010001000100000001010001000000010000000100011
1000111011101011111110101010101011111010111011001011101011101010101111101010101011000000000100001101
1010000000000000100000100010001010001010001010001010100000100010101010001010001000000000000000001001
1010111101111110101010101010001011001110001011111010011011111110101001101010101001101011101110111111
1000000000100000000010000000000010000000000010000000100000100000000000100000000010000010000000001001
1010001010111010101110000110111010001011101110101100101001101010001000101010100010101010111000101011
1000100000000000000010000010000000001000000010101000000000001000100000001010100000101010100000100001
1010101010100110100010101000111110100000100010101010111000101110111110001011101010101101111001111101
1000000000101000000000000010001010000000000000000000100010100000000000000000000010101000100000100001
1010111011101010100100111110111010101110101010111110101010111010100110101010011000000000110110101001
1000000000001000000000000000100000000000100000000000100010001010100000101010101000100010000010100001
1100101110111000100010100000111110101000111010111011101010011010101010111010001111011010100001111011
1000000000101000000010001010000010000000001000100000001010100010001010000000100000000010101010100001
1111111110101010101011101010100011101100101000110101101010101010101010111011100110001010101010100011
1010000000000010000010000000000010001000001000001000000010101000001010100000001000000000000000001001
1011111010101010001010011110111101101011101010101011100011001010101010101110101000110110100011100011
1000100000101000100000100010000000000000000010001010000010000000000010100000000000101010000010000001
1010101100101010101010101001101110100100101010101110001011011011101111111111001010100011111111100011
1000101010101000100000101010000010101000001010001000001010001000101000000010001010000000100010000001
1110101000111011101101110011001010001110001111001110100010111110111110101000011011101010110111101011
1000100010100010000010000000001000100000101000000000000010001000100000000010000000101000100010101011
1111101010101110101011111110001110101000100010101000100011101010101111100101101010011100101010101011
1010001000000010000000100000100010000010001000001010101000001000000010001000000000101000000010101001
1011001110010111101011101000111010101011000110111001101010111111101011101010101111100010101010100011
1000001000100000001000000000100010100000000010101000101000001010000000100010101000000010100000100001
1110111010101111111010001011101110011010100111101010001011011010101010001011101001110111111111111011
1000101000000010000000100000100000101000000000000000000010000010101000100000001000001000001010001011
1010101010100010111000101000100010101010000000101000101001101110111000100101000110001011111001101111
1010100000100010000000100010000000100010000000000010001000000000001000001000000000000000000010000011
1011101011101010100011101010111100100010100001101011100010001111111010101100111110101011111010101111
1010001000000000001010001010001000001010001000100000100000101010101000000000001000000000001010100001
1010011000101010111011001011101010101000101111011011101011100010101010111100101010101111111111001011
1000000010001000001000000000100000100000000000000010000000001000001010000000001000000010000000000001
1011001010101110101011111100011011000110101011111010101010001010101010010011110000101110101110101111
1000100000100010000010001000000000001000100000000000000000000010001000000010000010000010000000100001
1011111001111000101111101110101001011010101010111111010010111111111110101000111011101010011110101101
1010001000001010100010101000000000000000101000100000001010001010001000100000000000000010001000000001
1010101110101001111010101110111110101010111110001110100110111010111011001110100010010000111111101001
1010001010100000100000000000100000000010000010101010001000001000000010000000100010100010000010101001
1000111010011011111011101011111110101010111110110010100011001011101010101100101010111010100000101001
1000001000100000000000001010101000100010000000100010101000101000000000001000001000001000001000000001
1111111010001010111011001010001001101010101010101111100011011011000111001010101110111000001110101111
1000000000000000000000101000100000000010000000000000100000100000000000000000001000001000000000100001
1001100000100111111010011110111011111011111010101000101010100010101010010011111000001000101010111001
1000001000000000001000000000000010000000100010000010000000000000000010000000000010101000100010100011
1110100001101011101010111110101010111110100000111010101110110111000010101011101000101100101010111011
1010101100101110111010010010101011100111111100100010111010101011101010101011101111000011111010101011
1010000010001010000000000010000000101000001010001000100000100000000000100000000010100000100010100011
1011001010111000111000101010101110110010101011100010101000101001111110001100101110111010101100011011
1000001000000000100010000000000000001010000000000000000010101000000010000000101000000010000010001011
1010110100101011101111101010111010111000100011111110111011101000101011101010011010101010101110100011
1000001000100000100000001000000000100000100000000000000000001000100000101000100000000000001000100011
1010100110001010101110001011111010000000111010001010101010001011101010100111101011011110111010101111
1000000000000000001000001000000000001000001000000010000010100000000000100010100000100000101000000001
1110101000101110111111011110101010100011101110011110111010111010101010001010100010001010101010010011
1010100010100010101010001000000000001010000000000000100000000000000000000010100000001000000000000001
1011101100001111101010111011111010101110111010101000000100001110101110101010001011111111101000111111
1010000000000000100000101010100010001000001000000010001000000000000010000000000000001000000000000011
1010001110101010101010101010100110111010011010111010101010101000001010001011111010001011101011010001
1010100000000000100010100000100000001000000000000000000000001000001000000000000000000000000000001001
1011101110101010100010101011101010101110101111011010101011101010101010100000101010101110101011101101
1010000000100000100000000010001000100010001010001000000000101000001000100010100010101000001000000001
1010110010110011101000101110110001111010101010001000101000101011011010101011101010101000101011100011
1010001000100010000000001010100000100010001000000000000000101000000000100000001000000010100000000001
1000101010001011101010111011110011101110111010011110100110101000111011101110101110101011110000111011
1010000000100010000000000000000000001000000000000000000000000000000010000010100000000000000000001011
1001011110111010101111111000001010100111101010101000111100101110111011001111101010110011100010101111
1000000010101000000000100000100000000000000010001000001000000000101000000000100000000000001010000001
1011101010101110101010101110111010100011101010010100101011110010100010101001001010101010101010101011
1010000010000010001000100000001010000010100000000010001010000000000010000000000000100010101000001011
1011110010100010011010011110001010110010100010011110111110101010101010101010011010001010101010101011
1010001010101010000000101010100000100000001000000000000000100010001000000000101010100000000000001001
1110111110101010101011000011111101001011101111101000010110111101101010111110101011101010111111101011
1000100000100000100010000000000000000000101000001010101010001010000000100000101000000000100000100011
1100000010001001100110111110110011101011001010100011101000011010101010100011101010001111101111101111
1010000010000000000000001000100000000010001010100010100000000010000000001000000000000000101000000001
1010111001001101100011101000101110110110111010111010101010101001001011101011111010101110001011100011
1000001000100000100010001010101010001000100010100000000000000000001000100010000000101000100000001011
1011101010001111101010101011001010001110111011111000101101100110111011110010101011101011101001101001
1000101010000000000000001010100010101010000000000000101000101000001000100000100010001000100000101011
1110110010101010111011101010101000101010111110100100101110101110101011100010000010111001001010100011
1000101010101010000000100010101000000010100000000000000000000000101010101000001010000000100010000001
1111101010111100101011011110011010011110111010101011111010011011111110111110001010001011101110101101
1010001010000000000000001000001000100010000000001000000010001000000010000010000010100000100000001001
1001100010111010001010001110101011111111101111011011111011101110101011011110101100101111101010101011
1010000000001000101000000000100000000000000010000010001010100010001000001000000010001000001000100001
1010111010101100110110101010101010000111001010111110110110101100101011111111010011101011101010111111
1010101010001010000000100000001000000000100000100010000000000010101010001010000000000000100000100011
1010101010001000111100101011101000101001001010101000110111101011011100101011001001111010111011100011
1000000000000010000010100010100000000000000000000010001010001000100000001010001000000010000000100011
1000111011101011111110101010101011111010111011001011101011101010101111101010101011000000000100001101
1010000000000000100000100010001010001010001010001010100000100010101010001010001000000000000000001001
1010111101111110101010101010001011001110001011111010011011111110101001101010101001101011101110111111
1000000000100000000010000000000010000000000010000000100000100000000000100000000010000010000000001001
1010001010111010101110000110111010001011101110101100101001101010001000101010100010101010111000101011
1000100000000000000010000010000000001000000010101000000000001000100000001010100000101010100000100001
1010101010100110100010101000111110100000100010101010111000101110111110001011101010101101111001111101
1000000000101000000000000010001010000000000000000000100010100000000000000000000010101000100000100001
1010111011101010100100111110111010101110101010111110101010111010100110101010011000000000110110101001
1000000000001000000000000000100000000000100000000000100010001010100000101010101000100010000010100001
1100101110111000100010100000111110101000111010111011101010011010101010111010001111011010100001111011
1000000000101000000010001010000010000000001000100000001010100010001010000000100000000010101010100001
1111111110101010101011101010100011101100101000110101101010101010101010111011100110001010101010100011
1010000000000010000010000000000010001000001000001000000010101000001010100000001000000000000000001001
1011111010101010001010011110111101101011101010101011100011001010101010101110101000110110100011100011
1000100000101000100000100010000000000000000010001010000010000000000010100000000000101010000010000001
1010101100101010101010101001101110100100101010101110001011011011101111111111001010100011111111100011
1000101010101000100000101010000010101000001010001000001010001000101000000010001010000000100010000001
1110101000111011101101110011001010001110001111001110100010111110111110101000011011101010110111101011
1000100010100010000010000000001000100000101000000000000010001000100000000010000000101000100010101011
1111101010101110101011111110001110101000100010101000100011101010101111100101101010011100101010101011
1010001000000010000000100000100010000010001000001010101000001000000010001000000000101000000010101001
1011001110010111101011101000111010101011000110111001101010111111101011101010101111100010101010100011
1000001000100000001000000000100010100000000010101000101000001010000000100010101000000010100000100001
1110111010101111111010001011101110011010100111101010001011011010101010001011101001110111111111111011
1000101000000010000000100000100000101000000000000000000010000010101000100000001000001000001010001011
1111111111111111111111111111111111111111111111111111111111111111111111111111111111111111111111111111